1.108192e+02 0.000000e+00 1.028305e+02 7.988663e+00
9.476455e+01 0.000000e+00 1.028305e+02 -8.066002e+00
2.355322e+02 0.000000e+00 1.677399e+02 6.779234e+01
1.061187e+02 0.000000e+00 1.677399e+02 -6.162121e+01
7.204688e+01 0.000000e+00 7.145618e+01 5.907054e-01
7.057959e+01 0.000000e+00 7.145618e+01 -8.765853e-01
2.464116e+02 0.000000e+00 1.901949e+02 5.621676e+01
1.205094e+02 0.000000e+00 1.901949e+02 -6.968549e+01
1.812202e+02 0.000000e+00 1.610572e+02 2.016298e+01
1.355894e+02 0.000000e+00 1.610572e+02 -2.546779e+01
1.415123e+02 0.000000e+00 1.247286e+02 1.678364e+01
1.070894e+02 0.000000e+00 1.247286e+02 -1.763918e+01
1.289370e+02 0.000000e+00 1.499850e+02 -2.104801e+01
1.718027e+02 0.000000e+00 1.499850e+02 2.181765e+01
1.240197e+02 0.000000e+00 1.378299e+02 -1.381022e+01
1.680653e+02 0.000000e+00 1.378299e+02 3.023544e+01
1.488372e+02 0.000000e+00 1.452136e+02 3.623597e+00
1.422269e+02 0.000000e+00 1.452136e+02 -2.986736e+00
2.117464e+02 2.381591e+02 2.381591e+02 2.117464e+02
2.581272e+02 2.381591e+02 2.381591e+02 2.581272e+02
1.399762e+02 0.000000e+00 1.269377e+02 1.303847e+01
1.155264e+02 0.000000e+00 1.269377e+02 -1.141131e+01
2.573823e+02 0.000000e+00 2.307797e+02 2.660259e+01
2.022907e+02 0.000000e+00 2.307797e+02 -2.848897e+01
1.546106e+02 0.000000e+00 1.515362e+02 3.074395e+00
1.489623e+02 0.000000e+00 1.515362e+02 -2.573916e+00
1.178601e+02 0.000000e+00 1.340772e+02 -1.621711e+01
1.519820e+02 0.000000e+00 1.340772e+02 1.790472e+01
2.735713e+02 0.000000e+00 2.728876e+02 6.836622e-01
2.756663e+02 0.000000e+00 2.728876e+02 2.778648e+00
1.396947e+02 0.000000e+00 1.199396e+02 1.975502e+01
1.015313e+02 0.000000e+00 1.199396e+02 -1.840831e+01
2.358492e+02 0.000000e+00 2.089962e+02 2.685299e+01
1.887699e+02 0.000000e+00 2.089962e+02 -2.022627e+01
1.287403e+02 0.000000e+00 7.384515e+01 5.489517e+01
1.204002e+01 0.000000e+00 7.384515e+01 -6.180513e+01
2.108731e+02 0.000000e+00 1.438975e+02 6.697557e+01
1.143920e+02 0.000000e+00 1.438975e+02 -2.950551e+01
1.132937e+02 0.000000e+00 1.175584e+02 -4.264710e+00
1.223630e+02 0.000000e+00 1.175584e+02 4.804555e+00
2.493251e+02 0.000000e+00 2.192251e+02 3.010003e+01
1.915454e+02 0.000000e+00 2.192251e+02 -2.767970e+01
1.666362e+02 0.000000e+00 1.279365e+02 3.869971e+01
9.511225e+01 0.000000e+00 1.279365e+02 -3.282425e+01
1.221326e+02 0.000000e+00 1.308165e+02 -8.683965e+00
1.419548e+02 0.000000e+00 1.308165e+02 1.113824e+01
1.203161e+02 0.000000e+00 1.209628e+02 -6.466398e-01
1.211188e+02 0.000000e+00 1.209628e+02 1.559954e-01
6.301375e+01 0.000000e+00 6.032303e+01 2.690721e+00
5.730564e+01 0.000000e+00 6.032303e+01 -3.017383e+00
1.313012e+02 0.000000e+00 1.161604e+02 1.514078e+01
1.012557e+02 0.000000e+00 1.161604e+02 -1.490468e+01
