1.343481e+02 0.000000e+00 1.218096e+02 1.253853e+01
1.086944e+02 0.000000e+00 1.218096e+02 -1.311519e+01
2.098166e+02 0.000000e+00 1.439351e+02 6.588154e+01
8.563266e+01 0.000000e+00 1.439351e+02 -5.830245e+01
9.394769e+01 0.000000e+00 8.639986e+01 7.547826e+00
8.001768e+01 0.000000e+00 8.639986e+01 -6.382183e+00
2.311039e+02 0.000000e+00 1.749934e+02 5.611043e+01
1.058648e+02 0.000000e+00 1.749934e+02 -6.912862e+01
2.393880e+02 0.000000e+00 1.986432e+02 4.074485e+01
1.488402e+02 0.000000e+00 1.986432e+02 -4.980303e+01
1.274755e+02 0.000000e+00 1.152404e+02 1.223514e+01
1.026092e+02 0.000000e+00 1.152404e+02 -1.263123e+01
1.278277e+02 0.000000e+00 1.474383e+02 -1.961058e+01
1.687239e+02 0.000000e+00 1.474383e+02 2.128555e+01
1.258009e+02 0.000000e+00 1.308955e+02 -5.094586e+00
1.465294e+02 0.000000e+00 1.308955e+02 1.563387e+01
1.189064e+02 0.000000e+00 1.223531e+02 -3.446663e+00
1.259329e+02 0.000000e+00 1.223531e+02 3.579845e+00
9.697201e+01 0.000000e+00 1.156815e+02 -1.870949e+01
1.313775e+02 0.000000e+00 1.156815e+02 1.569604e+01
1.503792e+02 0.000000e+00 1.362422e+02 1.413704e+01
1.236779e+02 0.000000e+00 1.362422e+02 -1.256430e+01
2.682088e+02 0.000000e+00 2.231884e+02 4.502040e+01
1.682930e+02 0.000000e+00 2.231884e+02 -5.489539e+01
1.328683e+02 0.000000e+00 1.187056e+02 1.416264e+01
1.035231e+02 0.000000e+00 1.187056e+02 -1.518249e+01
1.319278e+02 0.000000e+00 1.462749e+02 -1.434705e+01
1.615647e+02 0.000000e+00 1.462749e+02 1.528977e+01
2.651986e+02 0.000000e+00 2.690207e+02 -3.822063e+00
2.750789e+02 0.000000e+00 2.690207e+02 6.058186e+00
1.280951e+02 0.000000e+00 1.075046e+02 2.059052e+01
8.813108e+01 0.000000e+00 1.075046e+02 -1.937351e+01
2.177971e+02 0.000000e+00 1.927289e+02 2.506814e+01
1.761431e+02 0.000000e+00 1.927289e+02 -1.658586e+01
1.163740e+02 0.000000e+00 7.510542e+01 4.126861e+01
2.910689e+01 0.000000e+00 7.510542e+01 -4.599853e+01
2.205250e+02 0.000000e+00 1.396210e+02 8.090402e+01
1.003990e+02 0.000000e+00 1.396210e+02 -3.922196e+01
1.010721e+02 0.000000e+00 1.119678e+02 -1.089568e+01
1.228673e+02 0.000000e+00 1.119678e+02 1.089950e+01
1.958273e+02 0.000000e+00 1.735874e+02 2.223998e+01
1.527209e+02 0.000000e+00 1.735874e+02 -2.086642e+01
3.256002e+02 2.710902e+02 2.710902e+02 3.256002e+02
2.259899e+02 2.710902e+02 2.710902e+02 2.259899e+02
1.273150e+02 0.000000e+00 1.411489e+02 -1.383394e+01
1.584055e+02 0.000000e+00 1.411489e+02 1.725661e+01
1.166272e+02 0.000000e+00 1.131392e+02 3.487976e+00
1.092445e+02 0.000000e+00 1.131392e+02 -3.894680e+00
6.869212e+01 0.000000e+00 6.037269e+01 8.319437e+00
5.059235e+01 0.000000e+00 6.037269e+01 -9.780338e+00
1.295638e+02 0.000000e+00 1.005264e+02 2.903740e+01
7.307218e+01 0.000000e+00 1.005264e+02 -2.745427e+01
